0 5 0 0 0 0 0 0 0 0
1 1 1 0 1 1 1 0 1 0
0 0 0 0 3 3 3 6 0 0
0 1 0 1 1 1 1 0 2 1
0 1 1 1 0 0 0 0 1 1
0 1 0 1 4 1 1 1 1 1
1 0 6 4 4 0 0 1 1 1
1 0 1 1 0 1 0 1 0 6
0 0 0 0 0 1 0 1 0 1
0 1 1 1 0 0 0 0 0 1